000000000000000
910111011111110
010101010001010
011101110118000
000000000000000